111111111111111
100000000000001
1000000000000011111
1001101000000000001
1001001000000001111
10010000000000001
10010110000000111
100000000111111
100000000000001
111111111111111
