111111111111111
100000000000001
100000000000001
100110100000001
100100100000001
100100100000001
100101100000001
100000000111111
100000000000001
111111111111111
